1111111111
1001000001
1011010101
1000010001
1111111111